酱	-chan
君	-kun
阿姨	a di
哥	ca
哥哥	ca ca
大人	đại nhân
大姐	đại tỉ
同学	đồng học
堂姐	đường tỉ
家主	gia chủ
学弟	học đệ
学妹	học muội
学姐	học tỉ
会长	hội trưởng
會長	hội trưởng
兄弟	huynh đệ
老师	lão sư
罗利	loli
妈妈	ma ma
妹妹	muội muội
夫人	phu nhân
天皇	thiên hoàng
千金	thiên kim
姐	tỉ
姐姐	tỉ tỉ
前辈	tiền bối
先生	tiên sinh
小兄弟	tiểu huynh đệ
小萝莉	tiểu loli
小蘿莉	tiểu loli
小娃娃	tiểu oa oa
小姐	tiểu thư
王后	vương hậu