酱	-chan
君	-kun
阿姨	a di
医生	bác sĩ
陛下	bệ hạ
公爵	công tước
药师	dược sư
大人	đại nhân
大法官	đại pháp quan
大叔	đại thúc
道友	đạo hữu
殿下	điện hạ
队长	đội trưởng
同学	bạn học
侯爵	hầu tước
皇	hoàng
兄	huynh
兄弟	huynh đệ
老师	lão sư
男爵	nam tước
女王	nữ vương
管家	quản gia
师弟	sư đệ
师兄	sư huynh
少爷	thiếu gia
叔叔	thúc thúc
上仙	thượng tiên
先生	tiên sinh
小姐	tiểu thư
长老	trưởng lão